#######
# @  .#
##    #
###  $#
# .$ ##
#######
