#######
#@*.  #
# $ $ #
# *$..#
##$. .#
##  $ #
## *  #
#######