#######
# @  .#
#  **$#
# $.$.#
### * #
### * #
###   #
###   #
#######