#######
# .$@##
# $*$##
#.$  ##
#. .$ #
# .$. #
#   ###
##  ###
#######   
